11111111111111
10000000000101
1P000101000101
100001C10001E1
11111111111111