11111111111111111111
1P100000000000000001
10100101111100000001
1010C100000100000001
10111100000100000001
10000100000100000001
10111100000100000001
10000000000100000001
100C00000001C00000E1
11111111111111111111