1111111111111111
1P00000000000001
1000101011100001
1000101000100001
1000111011100001
1000001010000001
1000001011100001
1C000000000000E1
1111111111111111