1111111111111111
1P00000000000001
1000C0C0CCC00001
1000C0C000C00001
1000CCC0CCC00001
100000C0C0000001
100000C0CCC00001
10000000000000E1
1111111111111111